77000088
58000740
15000043
10000030
58000074
50000040
75000048
78000780
00000000
00000000
00000000
