00018000
04300000
27081000
00003400
00018072
04300000
27081000
00003400
00000072
00000000
00000000
