00088000
00030000
00050000
00070000
00010000
00040000
00080000
00030000
00000000
00000000
00000000
