60E00E05
63000350
85400468
31000130
68000085
20000020
00000000
00000000
00000000
00000000
00000000
