40000003
41000230
35E00E57
84000340
01500520
03403700
00855400
00152000
00000000
00000000
00000000
