11000088
80000010
80000001
50505030
81835181
1F801F80
03700370
001F8000
00000000
00000000
00000000
