50000000
50000000
01347280
00000050
00000050
13472800
50000000
50000000
01347280
00000000
00000000
