02000000
80000000
13472813
00000040
00000070
04318200
07000000
20000000
81347280
00000000
00000000
