06600110
0R000R00
0R000R00
0R000R00
0R000R00
0R000R00
0R000R00
0R000R00
00000000
00000000
00000000
