04442220
40000020
04000020
41351320
03513510
00000000
00000000
00000000
00000000
00000000
00000000
