00088000
00030000
00014000
00020000
00014000
0R080R00
56565656
R0R0R0R0
00000000
00000000
00000000
