00453000
05005000
004F3450
05340040
03003F50
05F45300
00450000
00000000
00000000
00000000
00000000
