00348000
08004000
003F8530
08530050
05008F30
08F34800
00340030
0003F800
00008500
00000000
00000000
