00500E00
07006000
04005550
20000700
55550400
00800000
00600000
03000000
05000000
00000000
00000000
