00005000
74380000
20050000
00083470
20005002
74380000
00050002
00083470
00000000
00000000
00000000
