0000WR800
000WR0800
0000WR800
00004620
00006246
00004620
00006246
00004620
00006246
00000000
00000000
