00066000
00865000
00385200
04302700
07400740
27000430
52000038
50000080
00000000
00000000
00000000
