00007320
00R732R0
00R732R0
0R732R00
0R732R00
R732R000
RRRRR000
00000000
00000000
00000000
00000000
