80000008
80222080
08400480
03000300
02600620
03000300
00400400
00222000
00000000
00000000
00000000
