030R0702
R040R020
20R08030
01050R00
040R0400
R0301000
00R0R000
00080000
00000000
00000000
00000000
