00043100
00315400
0005F300
01340000
04513000
03F50000
00013400
00451300
0003F500
00000000
00000000
