00777700
00050000
00051000
00010000
00018000
00080000
00083000
00000000
00000000
00000000
00000000
