00700700
00757000
00051000
00515000
00018000
00383000
00083000
00030000
00000000
00000000
00000000
