6281345E
00005000
00055000
00500000
E5431826
00005000
00055000
00500000
6281345E
00000000
00000000
