30000003
23142310
40000004
14231420
00020000
00030000
00000000
00000000
00000000
00000000
00000000
