07700880
50000040
15000043
10000030
51000034
50000040
75000048
77000880
00000000
00000000
00000000
