6 6 1 1 1 6 6 6 6 6 6 6 6 6 6
6 6 1 2 1 6 6 6 6 6 6 6 6 6 6
6 6 1 0 1 1 1 1 6 6 6 6 6 6 6
1 1 1 4 5 4 2 1 6 6 6 6 6 6 6
1 2 0 4 0 1 1 1 6 6 6 6 6 6 6
1 1 1 1 4 1 6 6 6 6 6 6 6 6 6
6 6 6 1 2 1 6 6 6 6 6 6 6 6 6
6 6 6 1 1 1 6 6 6 6 6 6 6 6 6
6 6 6 6 6 6 6 6 6 6 6 6 6 6 6
6 6 6 6 6 6 6 6 6 6 6 6 6 6 6
6 6 6 6 6 6 6 6 6 6 6 6 6 6 6
6 6 6 6 6 6 6 6 6 6 6 6 6 6 6
6 6 6 6 6 6 6 6 6 6 6 6 6 6 6
6 6 6 6 6 6 6 6 6 6 6 6 6 6 6
6 6 6 6 6 6 6 6 6 6 6 6 6 6 6
