1 1 1 1 6 6 6 6 6 6 6 6 6 6 6
1 2 2 1 1 1 1 6 6 6 6 6 6 6 6
1 2 2 4 0 0 1 6 6 6 6 6 6 6 6
1 0 0 0 4 0 1 6 6 6 6 6 6 6 6
1 1 4 4 0 0 1 6 6 6 6 6 6 6 6
6 1 0 0 0 5 1 6 6 6 6 6 6 6 6
6 1 1 1 1 1 1 6 6 6 6 6 6 6 6
6 6 6 6 6 6 6 6 6 6 6 6 6 6 6
6 6 6 6 6 6 6 6 6 6 6 6 6 6 6
6 6 6 6 6 6 6 6 6 6 6 6 6 6 6
6 6 6 6 6 6 6 6 6 6 6 6 6 6 6
6 6 6 6 6 6 6 6 6 6 6 6 6 6 6
6 6 6 6 6 6 6 6 6 6 6 6 6 6 6
6 6 6 6 6 6 6 6 6 6 6 6 6 6 6
6 6 6 6 6 6 6 6 6 6 6 6 6 6 6
