1 1 1 1 1 1 1 1 1 1 1 1 6 6 6
1 5 0 0 0 0 0 0 0 0 0 1 6 6 6
1 0 4 0 4 0 4 0 4 0 4 1 6 6 6
1 4 0 4 0 4 0 4 0 4 0 1 6 6 6
1 0 4 0 4 0 4 0 4 0 4 1 6 6 6
1 4 0 4 0 4 0 4 0 4 0 1 6 6 6
1 2 4 2 4 2 4 2 4 2 4 1 6 6 6
1 4 2 4 2 4 2 4 2 4 2 1 6 6 6
1 2 2 2 2 2 2 2 2 2 2 1 6 6 6
1 2 2 2 2 2 2 2 2 2 2 1 6 6 6
1 1 1 1 1 1 1 1 1 1 1 1 6 6 6
6 6 6 6 6 6 6 6 6 6 6 6 6 6 6
6 6 6 6 6 6 6 6 6 6 6 6 6 6 6
6 6 6 6 6 6 6 6 6 6 6 6 6 6 6
6 6 6 6 6 6 6 6 6 6 6 6 6 6 6
