6 6 1 1 1 1 1 1 6 6 6 6 6 6 6
6 6 1 0 0 0 0 1 6 6 6 6 6 6 6
1 1 1 4 4 4 0 1 6 6 6 6 6 6 6
1 5 0 4 2 2 0 1 6 6 6 6 6 6 6
1 0 4 2 2 2 1 1 6 6 6 6 6 6 6
1 1 1 1 0 0 1 6 6 6 6 6 6 6 6
6 6 6 1 1 1 1 6 6 6 6 6 6 6 6
6 6 6 6 6 6 6 6 6 6 6 6 6 6 6
6 6 6 6 6 6 6 6 6 6 6 6 6 6 6
6 6 6 6 6 6 6 6 6 6 6 6 6 6 6
6 6 6 6 6 6 6 6 6 6 6 6 6 6 6
6 6 6 6 6 6 6 6 6 6 6 6 6 6 6
6 6 6 6 6 6 6 6 6 6 6 6 6 6 6
6 6 6 6 6 6 6 6 6 6 6 6 6 6 6
6 6 6 6 6 6 6 6 6 6 6 6 6 6 6
