6 6 1 1 1 1 1 6 6 6 6 6 6 6 6
1 1 1 0 0 5 1 6 6 6 6 6 6 6 6
1 0 0 4 2 0 1 1 6 6 6 6 6 6 6
1 0 0 2 4 2 0 1 6 6 6 6 6 6 6
1 1 1 0 3 4 0 1 6 6 6 6 6 6 6
6 6 1 0 0 0 1 1 6 6 6 6 6 6 6
6 6 1 1 1 1 1 6 6 6 6 6 6 6 6
6 6 6 6 6 6 6 6 6 6 6 6 6 6 6
6 6 6 6 6 6 6 6 6 6 6 6 6 6 6
6 6 6 6 6 6 6 6 6 6 6 6 6 6 6
6 6 6 6 6 6 6 6 6 6 6 6 6 6 6
6 6 6 6 6 6 6 6 6 6 6 6 6 6 6
6 6 6 6 6 6 6 6 6 6 6 6 6 6 6
6 6 6 6 6 6 6 6 6 6 6 6 6 6 6
6 6 6 6 6 6 6 6 6 6 6 6 6 6 6
