6 1 1 1 1 1 6 6 6 6 6 6 6 6 6
6 1 5 0 1 1 1 6 6 6 6 6 6 6 6
6 1 0 4 0 0 1 6 6 6 6 6 6 6 6
1 1 1 0 1 0 1 1 6 6 6 6 6 6 6
1 2 1 0 1 0 0 1 6 6 6 6 6 6 6
1 2 4 0 0 1 0 1 6 6 6 6 6 6 6
1 2 0 0 0 4 0 1 6 6 6 6 6 6 6
1 1 1 1 1 1 1 1 6 6 6 6 6 6 6
6 6 6 6 6 6 6 6 6 6 6 6 6 6 6
6 6 6 6 6 6 6 6 6 6 6 6 6 6 6
6 6 6 6 6 6 6 6 6 6 6 6 6 6 6
6 6 6 6 6 6 6 6 6 6 6 6 6 6 6
6 6 6 6 6 6 6 6 6 6 6 6 6 6 6
6 6 6 6 6 6 6 6 6 6 6 6 6 6 6
6 6 6 6 6 6 6 6 6 6 6 6 6 6 6
